NO textures/Mona_Lisa.png
SO textures/Wheat_Field.png
WE textures/the_starry_night.png
EA textures/girl_with_a_pearl_earring.png

C 0,0,33
F 60,179,110


111111111111111111111111111111111111
10000000001100000000000011
10110000011100000000000011
1001000000000N001000000011
11111111101100001110000111
10000000001100000111011111
11110111111101011100000011
11110111100001101110101001
11110111100001101110101001
11110111100001101110101001
11110111100001101110101001
11110111100001101110101001
11110111100001101110101001
11110111100001101110101001
11110111100001101110101001
11000001110101011111010011
 11111111111111111111111111